{
  "height": 23,
  "width": 128,
  "marbles": {
    "red": 3,
    "green": 3,
    "blue": 3
  },
  "start": {
    "x": 6,
    "y": 16
  },
  "finish": {
    "x": 0,
    "y": 0
  },
  "tiledata": [
    [408,511,512,511,512,511,512,511,512,511,544,509,0,0,535,512,511,538,0,0,0,464,469,0,0,0,0,0,0,0,0,0,0,0,0,0,0,0,0,464,469,0,0,0,0,519,520,423,459,550,463,503,504,423,459,550,439,440,441,503,504,438,439,548,549,550,439,548,549,550,551,548,549,550,551,457,439,548,549,503,504,503,504,438,439,440,441,503,504,438,439,457,439,316,317,1,242,241,0,0,0,476,477,400,482,475,470,471,472,512,319,532,511,410,411,406,409,512,511,512,511,318,319,297,298,410,411,406],
    [550,551,457,439,457,439,440,441,503,504,525,0,0,0,0,519,509,0,0,0,0,0,0,0,0,0,0,0,0,0,0,0,0,0,0,0,0,0,0,0,0,0,0,0,0,0,0,464,511,512,511,473,465,512,511,410,407,408,409,512,511,410,407,408,409,410,407,408,409,410,407,408,409,410,411,406,407,408,409,512,511,512,511,410,411,408,409,512,511,410,411,406,407,408,409,544,241,0,0,0,0,484,485,412,486,491,405,480,481,519,243,535,504,423,459,462,463,438,439,440,441,312,313,314,315,548,549,462],
    [410,407,406,407,406,407,408,409,544,509,0,0,0,0,0,0,0,0,0,0,0,0,0,0,0,0,0,0,0,0,0,0,0,0,0,0,0,0,0,0,0,0,0,0,0,0,0,0,521,503,506,0,0,535,504,423,459,462,463,503,504,423,459,550,551,548,549,550,439,548,549,550,551,548,549,460,461,550,551,440,441,503,504,423,459,462,463,438,551,548,549,460,461,462,463,525,0,0,0,0,0,0,0,424,492,487,419,488,489,0,0,0,545,512,511,318,319,410,411,408,409,410,411,406,407,408,409,512],
    [423,421,460,459,460,461,462,463,525,0,0,0,0,0,0,0,0,0,0,0,0,0,0,0,0,0,0,0,0,0,0,0,0,0,0,0,0,0,0,0,0,0,0,0,0,0,0,0,524,538,0,0,0,0,524,512,511,512,511,512,511,512,511,410,407,406,409,410,411,408,409,410,407,408,409,541,542,410,407,408,409,512,511,512,511,512,511,410,411,408,409,541,542,473,469,0,0,0,0,0,0,0,0,0,490,493,429,0,0,0,0,0,0,519,506,240,299,423,459,462,463,423,459,460,461,550,518,543],
    [432,433,552,470,471,472,473,469,0,0,0,0,0,0,0,0,0,0,0,0,0,0,0,0,0,0,0,0,0,0,0,0,0,0,0,0,0,0,0,0,0,0,0,0,0,0,0,0,0,0,0,0,0,0,0,535,504,438,439,457,439,457,439,548,549,550,551,457,516,515,439,548,549,550,551,457,551,548,549,550,551,457,439,440,441,503,504,423,459,462,463,465,506,0,0,0,0,0,0,0,0,0,0,0,482,491,0,0,0,0,0,0,0,0,0,0,524,512,511,473,469,464,465,466,467,468,469,430],
    [403,404,0,405,480,481,0,0,0,0,0,0,0,0,0,0,0,0,0,0,0,0,0,0,0,0,0,0,0,0,0,0,0,0,0,0,0,0,0,0,0,0,0,0,0,0,0,0,0,0,0,0,0,0,0,0,521,410,411,406,407,406,407,408,409,410,411,406,407,406,407,408,409,410,411,406,407,408,409,410,411,406,407,408,409,544,469,464,465,473,469,0,0,0,0,0,0,0,0,0,0,0,0,331,490,483,6,0,0,0,0,0,0,0,0,0,0,519,506,0,0,0,0,476,477,400,0,401],
    [416,417,418,419,488,489,0,0,0,0,0,0,0,0,0,0,0,0,0,0,0,0,0,0,0,0,0,0,0,0,0,0,0,0,0,0,0,0,0,0,0,0,0,0,0,0,0,0,0,0,0,0,0,0,0,0,524,423,459,460,461,462,459,420,422,423,421,460,459,460,461,462,463,423,459,460,461,462,463,423,459,460,461,462,463,546,0,0,0,0,0,0,0,0,0,0,0,0,0,0,331,6,2,494,495,496,497,6,0,0,0,0,0,0,0,0,0,0,0,0,0,0,0,484,485,412,413,414],
    [403,427,428,429,0,0,0,0,0,0,0,0,0,0,0,0,0,0,0,0,0,0,0,0,0,0,0,0,0,0,0,0,0,0,0,0,0,0,0,0,0,0,0,0,0,0,0,0,0,0,0,0,0,0,0,0,0,464,465,466,467,468,506,430,431,432,433,552,470,471,472,473,469,464,465,466,467,468,474,475,470,471,472,473,469,0,0,0,0,0,0,0,0,0,0,0,0,0,0,0,304,152,352,499,500,501,502,311,173,0,0,0,0,0,0,0,0,0,0,0,0,0,0,0,0,424,425,426],
    [416,436,437,0,0,0,0,0,0,0,0,0,0,0,0,0,0,0,2,6,2,332,0,0,0,0,0,0,0,0,0,0,0,0,0,0,0,0,0,0,0,2,11,6,0,0,0,0,0,0,0,0,0,0,0,0,0,0,0,476,477,400,0,401,402,403,404,0,405,480,481,0,0,0,0,476,477,400,482,483,405,480,481,0,0,0,0,0,0,0,0,0,0,0,0,0,0,0,0,172,157,158,60,61,58,59,60,61,159,309,173,0,0,0,0,0,0,0,0,0,0,0,0,0,0,0,434,435],
    [403,404,0,0,0,0,0,0,0,0,0,0,0,0,0,2,11,6,339,340,341,154,331,11,6,0,0,0,0,0,0,0,0,0,0,0,0,0,2,11,6,339,340,303,11,6,2,6,0,0,0,0,0,0,0,0,0,0,0,484,485,412,413,414,415,416,417,418,419,488,489,0,0,0,0,484,485,412,486,487,419,488,489,0,0,0,0,0,0,0,0,0,0,0,0,0,0,0,324,183,168,169,70,71,68,69,70,71,170,171,184,325,0,0,0,0,0,0,0,0,0,0,0,0,0,0,0,401],
    [416,443,0,0,0,0,0,0,0,0,0,0,0,0,86,310,353,354,348,349,350,351,351,356,5,6,0,0,0,0,0,0,0,2,639,640,331,6,304,152,354,348,349,350,351,351,353,311,87,0,0,0,0,0,0,0,0,0,0,0,0,424,425,426,402,403,427,428,429,0,0,0,0,0,0,0,0,424,492,493,429,0,0,0,0,0,0,0,0,0,0,0,0,0,2,6,221,220,149,200,141,79,127,128,78,79,127,128,141,79,197,150,224,0,0,0,0,0,0,0,2,44,45,46,0,0,0,442],
    [403,404,0,0,0,0,0,0,0,0,0,0,0,0,7,58,59,60,61,58,59,60,61,98,357,5,332,0,0,0,331,332,2,342,652,653,333,152,182,183,58,59,60,61,58,59,135,136,300,0,0,0,0,0,0,0,0,0,0,0,0,0,434,435,415,416,436,437,0,0,639,640,0,0,0,0,0,0,490,491,0,0,0,0,0,0,0,0,0,0,0,0,2,11,333,343,9,1,1,128,70,92,66,67,91,92,66,67,70,92,121,231,244,220,224,0,0,0,2,11,333,47,48,49,331,11,444,445],
    [416,443,44,41,46,0,0,2,6,2,6,0,2,6,331,68,69,70,71,68,69,70,71,9,1,4,5,11,11,332,304,5,333,152,666,667,157,158,199,200,68,69,70,71,68,69,147,148,320,0,0,0,0,0,0,0,0,0,0,0,0,0,0,401,402,403,404,0,0,0,652,653,0,0,0,0,0,0,482,483,0,0,0,0,0,0,0,0,2,11,6,2,361,362,340,3,343,9,66,67,128,128,139,140,66,67,139,140,128,1,1,231,231,231,244,223,2,11,333,152,353,50,51,52,385,387,450,451],
    [447,448,47,48,49,6,2,368,369,341,5,6,339,340,341,78,79,127,128,78,79,127,128,343,10,9,305,340,303,306,4,152,182,183,60,61,168,169,99,100,141,142,99,100,141,142,62,63,11,6,0,0,0,0,2,11,6,0,0,0,0,0,0,442,415,416,443,6,0,0,660,661,639,640,11,6,0,331,490,491,332,331,332,2,332,0,0,2,333,152,385,351,374,375,384,354,153,307,139,140,66,67,91,92,76,77,91,92,66,67,30,9,231,231,231,30,333,152,157,158,82,83,60,61,58,59,60,61],
    [453,454,50,51,52,353,354,381,382,350,353,354,348,349,350,164,165,166,167,164,165,166,167,354,353,354,348,349,350,351,157,158,199,200,70,71,141,142,68,69,70,71,68,69,70,71,72,73,305,340,11,6,326,327,339,340,303,6,2,11,332,2,444,445,446,447,448,449,6,2,668,669,652,653,340,154,2,494,495,496,497,302,340,341,5,6,2,152,182,183,122,123,1,1,122,123,159,160,156,92,139,140,127,128,1,1,127,128,139,140,29,28,10,9,30,152,182,183,168,169,93,94,70,71,68,69,70,71],
    [58,59,60,61,58,59,60,61,58,59,58,59,60,61,58,59,60,61,58,59,60,61,58,59,60,61,58,59,60,61,168,169,99,100,99,100,70,71,78,79,127,128,78,79,127,128,115,144,348,349,351,354,664,665,348,349,350,387,354,388,354,456,450,451,452,453,454,455,456,351,666,667,666,667,349,351,354,499,500,501,502,348,349,350,385,354,157,158,199,200,145,146,62,63,145,146,170,171,159,160,164,165,166,167,166,167,166,167,164,165,351,352,351,352,157,158,199,200,141,142,78,79,99,100,141,142,99,100],
    [68,69,70,71,68,69,70,71,68,69,68,69,70,71,68,69,70,71,68,69,70,71,68,69,70,71,68,69,70,71,141,142,68,69,68,69,127,128,91,92,66,67,91,92,66,67,70,75,122,123,105,106,58,59,60,61,58,59,60,61,58,59,60,61,58,59,60,61,58,59,60,61,58,59,1,1,58,59,60,61,58,59,60,61,58,59,168,169,68,69,115,116,68,69,115,116,141,142,170,171,58,59,60,61,58,59,60,61,58,59,60,61,58,59,168,169,68,69,70,71,91,92,68,69,70,71,68,69],
    [141,142,99,100,141,142,99,100,141,142,141,142,99,100,141,142,99,100,141,142,99,100,141,142,99,100,141,142,99,100,70,71,78,79,78,79,66,67,1,1,76,77,1,1,76,77,127,63,145,146,70,71,68,69,70,71,68,69,70,71,68,69,70,71,68,69,70,71,68,69,70,71,68,69,62,63,68,69,70,71,68,69,70,71,68,69,141,142,78,79,70,71,78,79,70,71,70,71,141,142,68,69,70,71,68,69,70,71,68,69,70,71,68,69,141,142,78,79,127,128,127,128,78,79,127,128,78,79],
    [70,71,68,69,70,71,68,69,70,71,70,71,68,69,70,71,68,69,70,71,68,69,70,71,68,69,70,71,68,69,127,128,91,92,91,92,139,140,1,1,1,1,1,1,1,1,66,67,115,116,99,100,141,142,99,100,141,142,99,100,141,142,99,100,141,142,99,100,141,142,99,100,141,142,68,69,141,142,99,100,141,142,99,100,141,142,70,71,91,92,66,67,91,92,66,67,127,128,70,71,141,142,68,69,141,142,99,100,141,142,99,100,141,142,70,71,91,92,1,1,1,1,91,92,1,1,91,92],
    [127,128,78,79,127,128,78,79,127,128,127,128,78,79,127,128,78,79,127,128,78,79,127,128,78,79,127,128,78,79,66,67,127,128,127,128,91,92,1,1,1,1,1,1,1,1,76,140,70,71,66,67,70,71,68,69,70,71,68,69,70,71,68,69,70,71,68,69,70,71,68,69,70,71,78,79,70,71,68,69,70,71,68,69,70,71,127,128,66,67,76,77,1,1,76,77,1,1,66,67,70,71,78,79,70,71,68,69,70,71,68,69,70,71,66,67,1,1,1,1,1,1,1,1,1,1,1,1],
    [66,67,91,92,66,67,91,92,66,67,66,67,91,92,66,67,91,92,66,67,91,92,66,67,91,92,66,67,91,92,139,140,1,1,1,1,1,1,1,1,1,1,1,1,1,1,1,92,66,67,76,77,127,128,78,79,127,128,78,79,127,128,78,79,127,128,78,79,127,128,78,79,127,128,91,92,127,128,78,79,127,128,78,79,127,128,66,67,76,77,1,1,1,1,1,1,1,1,76,77,66,67,91,92,66,67,78,79,66,67,78,79,66,67,76,77,1,1,1,1,1,1,1,1,1,1,1,1],
    [76,77,127,128,76,77,127,128,76,77,76,77,127,128,76,77,127,128,76,77,127,128,76,77,127,128,76,77,127,128,91,92,1,1,1,1,1,1,1,1,1,1,1,1,1,1,1,1,76,77,1,1,66,67,91,92,66,67,91,92,66,67,91,92,66,67,91,92,66,67,91,92,66,67,127,128,66,67,91,92,66,67,91,92,66,67,76,77,1,1,1,1,1,1,1,1,1,1,1,1,76,77,1,1,76,77,91,92,76,77,91,92,76,77,1,1,1,1,1,1,1,1,1,1,1,1,1,1],
    [1,1,1,1,1,1,1,1,1,1,1,1,1,1,1,1,1,1,1,1,1,1,1,1,1,1,1,1,1,1,1,1,1,1,1,1,1,1,1,1,1,1,1,1,1,1,1,1,1,1,1,1,76,77,1,1,76,77,1,1,76,77,1,1,76,77,1,1,76,77,1,1,76,77,1,1,76,77,1,1,76,77,1,1,76,77,1,1,1,1,1,1,1,1,1,1,1,1,1,1,1,1,1,1,1,1,1,1,1,1,1,1,1,1,1,1,1,1,1,1,1,1,1,1,1,1,1,1]		
  ],
  "collisiondata": [
    [0,0,0,0,0,0,0,0,0,0,0,0,0,0,0,0,0,0,0,0,0,0,0,0,0,0,0,0,0,0,0,0,0,0,0,0,0,0,0,0,0,0,0,0,0,0,0,0,0,0,0,0,0,0,0,0,0,0,0,0,0,0,0,0,0,0,0,0,0,0,0,0,0,0,0,0,0,0,0,0,0,0,0,0,0,0,0,0,0,0,0,0,0,0,0,0,0,0,0,0,0,0,0,0,0,0,0,0,0,0,0,0,0,0,0,0,0,0,0,0,0,0,0,0,0,0,0,0,0],
    [0,0,0,0,0,0,0,0,0,0,0,0,0,0,0,0,0,0,0,0,0,0,0,0,0,0,0,0,0,0,0,0,0,0,0,0,0,0,0,0,0,0,0,0,0,0,0,0,0,0,0,0,0,0,0,0,0,0,0,0,0,0,0,0,0,0,0,0,0,0,0,0,0,0,0,0,0,0,0,0,0,0,0,0,0,0,0,0,0,0,0,0,0,0,0,0,0,0,0,0,0,0,0,0,0,0,0,0,0,0,0,0,0,0,0,0,0,0,0,0,0,0,0,0,0,0,0,0,0],
    [0,0,0,0,0,0,0,0,0,0,0,0,0,0,0,0,0,0,0,0,0,0,0,0,0,0,0,0,0,0,0,0,0,0,0,0,0,0,0,0,0,0,0,0,0,0,0,0,0,0,0,0,0,0,0,0,0,0,0,0,0,0,0,0,0,0,0,0,0,0,0,0,0,0,0,0,0,0,0,0,0,0,0,0,0,0,0,0,0,0,0,0,0,0,0,0,0,0,0,0,0,0,0,0,0,0,0,0,0,0,0,0,0,0,0,0,0,0,0,0,0,0,0,0,0,0,0,0,0],
    [0,0,0,0,0,0,0,0,0,0,0,0,0,0,0,0,0,0,0,0,0,0,0,0,0,0,0,0,0,0,0,0,0,0,0,0,0,0,0,0,0,0,0,0,0,0,0,0,0,0,0,0,0,0,0,0,0,0,0,0,0,0,0,0,0,0,0,0,0,0,0,0,0,0,0,0,0,0,0,0,0,0,0,0,0,0,0,0,0,0,0,0,0,0,0,0,0,0,0,0,0,0,0,0,0,0,0,0,0,0,0,0,0,0,0,0,0,0,0,0,0,0,0,0,0,0,0,0,0],
    [0,0,0,0,0,0,0,0,0,0,0,0,0,0,0,0,0,0,0,0,0,0,0,0,0,0,0,0,0,0,0,0,0,0,0,0,0,0,0,0,0,0,0,0,0,0,0,0,0,0,0,0,0,0,0,0,0,0,0,0,0,0,0,0,0,0,0,0,0,0,0,0,0,0,0,0,0,0,0,0,0,0,0,0,0,0,0,0,0,0,0,0,0,0,0,0,0,0,0,0,0,0,0,100,0,0,102,0,0,0,0,0,0,0,0,0,0,0,0,0,0,0,0,0,0,0,0,0,0],
    [0,0,0,0,0,0,0,0,0,0,0,0,0,0,0,0,0,0,0,0,0,0,0,0,0,0,0,0,0,0,0,0,0,0,0,0,0,0,0,0,0,0,0,0,0,0,0,0,0,0,0,0,0,0,0,0,0,0,0,0,0,0,0,0,0,0,0,0,0,0,0,0,0,0,0,0,0,0,0,0,0,0,0,0,0,0,0,0,0,0,0,0,0,0,0,0,0,0,0,0,0,0,122,0,0,0,0,101,0,0,0,0,0,0,0,0,0,0,0,0,0,0,0,0,0,0,0,0,0],
    [0,0,0,0,0,0,0,0,0,0,0,0,0,0,0,0,0,0,0,0,0,0,0,0,0,0,0,0,0,0,0,0,0,0,0,0,0,0,0,0,0,0,0,0,0,0,0,0,0,0,0,0,0,0,0,0,0,0,0,0,0,0,0,0,0,0,0,0,0,0,0,0,0,0,0,0,0,0,0,0,0,0,0,0,0,0,0,0,0,0,0,0,0,0,0,0,0,0,0,0,0,0,0,0,0,0,0,0,0,0,0,0,0,0,0,0,0,0,0,0,0,0,0,0,0,0,0,0,0],
    [0,0,0,0,0,0,0,0,0,0,0,0,0,0,0,0,0,0,0,0,0,0,0,0,0,0,0,0,0,0,0,0,0,0,0,0,0,0,0,0,0,0,0,0,0,0,0,0,0,0,0,0,0,0,0,0,0,0,0,0,0,0,0,0,0,0,0,0,0,0,0,0,0,0,0,0,0,0,0,0,0,0,0,0,0,0,0,0,0,0,0,0,0,0,0,0,0,0,0,0,0,0,0,0,0,0,0,0,0,0,0,0,0,0,0,0,0,0,0,0,0,0,0,0,0,0,0,0,0],
    [0,0,0,0,0,0,0,0,0,0,0,0,0,0,0,119,0,102,0,0,0,0,0,0,0,0,0,0,0,0,0,0,0,0,0,0,0,0,0,119,0,0,0,0,0,0,0,0,0,0,0,0,0,0,0,0,0,0,0,0,0,0,0,0,0,0,0,0,0,0,0,0,0,0,0,0,0,0,0,0,0,0,0,0,0,0,0,0,0,0,0,0,0,0,0,0,0,0,0,0,4,5,2,2,2,2,2,2,6,7,0,0,0,0,0,0,0,0,0,0,0,0,0,0,0,0,0,0,0],
    [0,0,0,0,0,0,0,0,0,0,0,0,0,0,0,0,0,0,0,0,0,0,0,0,0,0,0,0,0,0,0,0,0,0,0,0,0,0,0,0,0,0,0,0,0,0,0,0,0,0,0,0,0,0,0,0,0,0,0,0,0,0,0,0,0,0,0,0,0,0,0,0,0,0,0,0,0,0,0,0,0,0,0,0,0,0,0,0,0,0,0,0,0,0,0,0,0,0,4,5,2,0,0,0,0,0,0,0,0,2,6,7,0,0,0,0,0,0,0,0,0,103,0,0,0,0,110,0,0],
    [0,0,0,0,0,0,0,0,0,0,0,0,0,0,0,0,0,0,0,0,0,0,0,0,0,0,0,0,0,0,0,0,0,0,2,2,0,0,0,0,0,0,0,0,0,0,0,0,0,0,0,0,0,0,0,0,0,0,0,0,0,0,0,0,0,0,0,0,0,0,119,0,0,0,0,0,0,0,0,0,0,0,0,0,0,0,0,0,0,0,0,0,0,0,0,0,0,0,0,0,0,0,0,0,0,0,0,0,0,0,0,0,0,0,0,0,0,0,0,0,0,0,0,0,0,0,0,0,0],
    [0,0,0,0,0,0,0,0,0,0,0,0,0,103,2,2,2,2,2,2,2,2,2,2,0,0,0,0,0,0,0,0,0,0,0,0,0,0,4,5,1,1,1,1,1,1,1,1,2,0,0,0,0,0,0,0,0,0,0,0,0,0,0,0,0,0,0,0,0,0,2,2,0,0,0,0,0,0,0,0,0,0,0,0,0,0,0,0,0,0,0,0,0,0,0,0,0,0,119,0,0,0,0,0,0,0,0,0,0,0,0,0,0,0,0,0,0,0,0,0,0,0,0,0,0,0,0,0,0],
    [0,0,0,0,0,100,13,13,13,0,0,101,0,0,0,0,0,0,0,0,0,0,0,119,0,0,0,0,0,0,0,0,0,0,0,0,4,5,1,1,1,1,1,1,1,1,1,1,0,103,0,0,0,0,0,0,0,0,0,0,0,0,127,0,0,0,0,0,0,0,0,0,122,0,0,0,0,0,0,0,0,0,0,0,0,0,0,0,0,0,0,0,0,0,0,0,0,0,0,0,0,0,0,0,0,0,0,0,0,101,0,0,0,0,0,0,0,0,0,0,0,0,0,0,0,0,0,0,0],
    [0,0,0,0,0,13,13,13,13,0,0,0,0,0,0,0,0,0,0,0,0,0,0,0,0,0,0,0,0,0,0,0,4,5,1,1,1,1,1,1,1,1,1,1,1,1,1,1,0,0,103,0,100,123,0,0,0,0,0,0,0,124,0,0,0,0,0,0,0,0,0,0,2,2,0,101,0,0,0,0,0,0,0,0,0,0,0,0,0,0,0,0,0,0,0,0,0,0,0,0,0,0,0,0,0,0,0,0,0,0,0,0,100,103,124,0,0,0,4,5,1,1,1,1,1,1,1,1,0],
    [0,0,0,0,0,13,13,13,13,0,0,0,0,0,0,0,0,0,0,0,0,0,0,0,0,0,0,0,0,0,4,5,1,1,1,1,1,1,1,1,1,1,1,1,1,1,1,1,0,0,0,0,1,1,0,0,0,0,0,0,0,115,0,0,0,0,0,0,125,0,0,0,0,0,0,0,0,0,0,0,0,0,0,0,0,0,102,0,4,5,1,1,1,1,1,1,6,7,0,0,0,0,0,0,0,0,0,0,0,0,0,0,0,0,102,0,4,5,1,1,1,1,1,1,1,1,1,1,0],
    [1,1,1,1,1,1,1,1,1,1,1,1,1,1,1,1,1,1,1,1,1,1,1,1,1,1,1,1,1,1,1,1,1,1,1,1,1,1,1,1,1,1,1,1,1,1,1,1,0,0,0,0,1,1,0,0,0,0,0,0,0,0,0,0,0,0,0,0,0,0,0,0,0,0,0,0,0,0,0,0,0,0,0,0,0,0,4,5,1,1,1,1,1,1,1,1,1,1,6,7,0,0,0,0,0,0,0,0,0,0,0,0,0,0,4,5,1,1,1,1,1,1,1,1,1,1,1,1,0],
    [1,1,1,1,1,1,1,1,1,1,1,1,1,1,1,1,1,1,1,1,1,1,1,1,1,1,1,1,1,1,1,1,1,1,1,1,1,1,1,1,1,1,1,1,1,1,1,1,1,1,1,1,1,1,1,1,1,1,1,1,1,1,1,1,1,1,1,1,1,1,1,1,1,1,1,1,1,1,1,1,1,1,1,1,1,1,1,1,1,1,1,1,1,1,1,1,1,1,1,1,1,1,1,1,1,1,1,1,1,1,1,1,1,1,1,1,1,1,1,1,1,1,1,1,1,1,1,1,0],
    [1,1,1,1,1,1,1,1,1,1,1,1,1,1,1,1,1,1,1,1,1,1,1,1,1,1,1,1,1,1,1,1,1,1,1,1,1,1,1,1,1,1,1,1,1,1,1,1,1,1,1,1,1,1,1,1,1,1,1,1,1,1,1,1,1,1,1,1,1,1,1,1,1,1,1,1,1,1,1,1,1,1,1,1,1,1,1,1,1,1,1,1,1,1,1,1,1,1,1,1,1,1,1,1,1,1,1,1,1,1,1,1,1,1,1,1,1,1,1,1,1,1,1,1,1,1,1,1,0],
    [1,1,1,1,1,1,1,1,1,1,1,1,1,1,1,1,1,1,1,1,1,1,1,1,1,1,1,1,1,1,1,1,1,1,1,1,1,1,1,1,1,1,1,1,1,1,1,1,1,1,1,1,1,1,1,1,1,1,1,1,1,1,1,1,1,1,1,1,1,1,1,1,1,1,1,1,1,1,1,1,1,1,1,1,1,1,1,1,1,1,1,1,1,1,1,1,1,1,1,1,1,1,1,1,1,1,1,1,1,1,1,1,1,1,1,1,1,1,1,1,1,1,1,1,1,1,1,1,0],
    [1,1,1,1,1,1,1,1,1,1,1,1,1,1,1,1,1,1,1,1,1,1,1,1,1,1,1,1,1,1,1,1,1,1,1,1,1,1,1,1,1,1,1,1,1,1,1,1,1,1,1,1,1,1,1,1,1,1,1,1,1,1,1,1,1,1,1,1,1,1,1,1,1,1,1,1,1,1,1,1,1,1,1,1,1,1,1,1,1,1,1,1,1,1,1,1,1,1,1,1,1,1,1,1,1,1,1,1,1,1,1,1,1,1,1,1,1,1,1,1,1,1,1,1,1,1,1,1,0],
    [1,1,1,1,1,1,1,1,1,1,1,1,1,1,1,1,1,1,1,1,1,1,1,1,1,1,1,1,1,1,1,1,1,1,1,1,1,1,1,1,1,1,1,1,1,1,1,1,1,1,1,1,1,1,1,1,1,1,1,1,1,1,1,1,1,1,1,1,1,1,1,1,1,1,1,1,1,1,1,1,1,1,1,1,1,1,1,1,1,1,1,1,1,1,1,1,1,1,1,1,1,1,1,1,1,1,1,1,1,1,1,1,1,1,1,1,1,1,1,1,1,1,1,1,1,1,1,1,0],
    [1,1,1,1,1,1,1,1,1,1,1,1,1,1,1,1,1,1,1,1,1,1,1,1,1,1,1,1,1,1,1,1,1,1,1,1,1,1,1,1,1,1,1,1,1,1,1,1,1,1,1,1,1,1,1,1,1,1,1,1,1,1,1,1,1,1,1,1,1,1,1,1,1,1,1,1,1,1,1,1,1,1,1,1,1,1,1,1,1,1,1,1,1,1,1,1,1,1,1,1,1,1,1,1,1,1,1,1,1,1,1,1,1,1,1,1,1,1,1,1,1,1,1,1,1,1,1,1,0],
    [1,1,1,1,1,1,1,1,1,1,1,1,1,1,1,1,1,1,1,1,1,1,1,1,1,1,1,1,1,1,1,1,1,1,1,1,1,1,1,1,1,1,1,1,1,1,1,1,1,1,1,1,1,1,1,1,1,1,1,1,1,1,1,1,1,1,1,1,1,1,1,1,1,1,1,1,1,1,1,1,1,1,1,1,1,1,1,1,1,1,1,1,1,1,1,1,1,1,1,1,1,1,1,1,1,1,1,1,1,1,1,1,1,1,1,1,1,1,1,1,1,1,1,1,1,1,1,1,0],
    [0,0,0,0,0,0,0,0,0,0,0,0,0,0,0,0,0,0,0,0,0,0,0,0,0,0,0,0,0,0,0,0,0,0,0,0,0,0,0,0,0,0,0,0,0,0,0,0,0,0,0,0,0,0,0,0,0,0,0,0,0,0,0,0,0,0,0,0,0,0,0,0,0,0,0,0,0,0,0,0,0,0,0,0,0,0,0,0,0,0,0,0,0,0,0,0,0,0,0,0,0,0,0,0,0,0,0,0,0,0,0,0,0,0,0,0,0,0,0,0,0,0,0,0,0,0,0,0,0]
  ]
}